A funeral without a body
An Interactive Fiction by Phillip Tanton "A funeral was schedualed in your funeral house. UPS was going to bring in everything: the corpse, box and fine clothes. But they haven't sent ir yet and the funeral is tomarrow. So, as the director of the house you must bring everything together and hope they don't ask to see the body."
Release 1 / Serial number 141020 / Inform 7 build 6L38 (I6/v6.33 lib 6/12N) SD

Funeral House
This is where all the magic happens (so to speak). In reality it is a large room with oak walls and an old dusty carpet on the bottom.

You can see a Table here.

>up
2nd Floor of Hospital

>down
1st floor of Hospital

* * *

>take all
There are none at all available!

* * *

>e
Bank
You can see Banker here.

* * *

>n
shop
You can see circular saw (empty) here.

>w
Lumber yard
You can see cut plank here.

* * *

>n
1st floor of Hospital
What is the waiting room should be called the emergancy room. It is usually bustling with people but today it is earily quiet.

>w
You can't go that way.

>e
You can't go that way.

>s
Funeral House

* * *

>n
1st floor of Hospital
What is the waiting room should be called the emergancy room. It is usually bustling with people but today it is earily quiet.

>s
Funeral House

>w
You can't go that way.

* * *

>e
You can't go that way.

>n
1st floor of Hospital

>e
Bank

>n
Main road

>n
shop
You can see circular saw here.

>turn on circular saw
You switch circular saw on.

* * *

>s
Funeral House

>e
You can't go that way.

* * *

>n
1st floor of Hospital

>nn
That's not a verb I recognise.

>ne
You can't go that way.

>e
Bank
You can see Banker here.

* * *

>w
Lumber yard
You can see cut plank here.

>get plank
Taken.

>w
You can't go that way.

>e
shop
You can see circular saw (empty) here.

>put plank in saw
You put cut plank into circular saw.

>i
You are carrying nothing.

* * *

>n
1st floor of Hospital
What is the waiting room should be called the emergancy room. It is usually bustling with people but today it is earily quiet.

>n
You can't go that way.

* * *

>w
You can't go that way.

>e
Bank
You can see Banker here.

>e
You can't go that way.

>n
Main road

* * *

>sit at table
I didn't understand that sentence.

* * *

>sit on table
That's not something you can sit down on.