A funeral without a body
An Interactive Fiction by Phillip Tanton "A funeral was scheduled in your funeral house. UPS was going to bring in everything: the corpse, box and fine clothes. But they haven't sent it yet and the funeral is tomorrow. So, as the director of the house you must bring everything together and hope they don't ask to see the body. In this case everything is a body, some nice clothes and a coffin. When you get these three things, COMBINE one with another to make a full casket.  "
Release 1 / Serial number 141025 / Inform 7 build 6L38 (I6/v6.33 lib 6/12N) SD

Funeral House
This is where all the magic happens (so to speak). In reality it is a large room with oak walls and an old dusty in the front. If you bring the full casket together put it here to let the funeral continue.

>bring casket
That's not a verb I recognise.

>north
1st floor of Hospital
What is the waiting room should be called the emergency room. It is usually bustling with people but today it is eerily quiet.

>east
Bank
The safest place in the town. Where else would you keep your money. The banker is here sitting next to a counter.

You can see Banker here.

>see banker
That's not a verb I recognise.

>banker
That's not a verb I recognise.

>inspect banker
That's not a verb I recognise.

>talk to banker
Your bank account seems to be empty.

>okay
That's not a verb I recognise.

>west
1st floor of Hospital
What is the waiting room should be called the emergency room. It is usually bustling with people but today it is eerily quiet.

>up
2nd Floor of Hospital
This is where the worst patients are kept. there seems to be a couple not breathing. there is a body in here.

You can see corpse and Bed here.

>see corpse
That's not a verb I recognise.

>inspect corpse
That's not a verb I recognise.

>look at corpse
You see nothing special about corpse.

>look at bed
A white sanitary bed used in hospitals.

>down
1st floor of Hospital
What is the waiting room should be called the emergency room. It is usually bustling with people but today it is eerily quiet.

>south
Funeral House
This is where all the magic happens (so to speak). In reality it is a large room with oak walls and an old dusty in the front. If you bring the full casket together put it here to let the funeral continue.

>south
Graveyard
It's a graveyard, what do you expect? A haunted house... There seems to be a fresh grave here mabye we should check it out.

>look at grave
In headstone is ID card.

>look at id
Jonathan Nakagawa, 6/7/99... It seems to be the dead person.

>take id
Taken.

>okay
That's not a verb I recognise.

>north
Funeral House
This is where all the magic happens (so to speak). In reality it is a large room with oak walls and an old dusty in the front. If you bring the full casket together put it here to let the funeral continue.

>north
1st floor of Hospital
What is the waiting room should be called the emergency room. It is usually bustling with people but today it is eerily quiet.

>up
2nd Floor of Hospital
This is where the worst patients are kept. there seems to be a couple not breathing. there is a body in here.

You can see corpse and Bed here.

* * *

>see corpse
That's not a verb I recognise.

>down
1st floor of Hospital
What is the waiting room should be called the emergency room. It is usually bustling with people but today it is eerily quiet.

>east
Bank
The safest place in the town. Where else would you keep your money. The banker is here sitting next to a counter.

You can see Banker here.

>talk to banker
Ah yes Mr. Nakagawa here is your money.

>take money
You can't see any such thing.

>east
clothing emporium
Some very nice clothes are made here. A tailor and a pedestal is here.

>look at tailer
You can't see any such thing.

>look at tailor
You see nothing special about Tailor.

>talk to tailor
I will make some clothes for you right away.

>okay
That's not a verb I recognise.

>look at pedestal
You see nothing special about pedestal.

>inventory
You are carrying:
  clothes
  wad of cash
  ID card

>okay
That's not a verb I recognise.

>west
Bank
The safest place in the town. Where else would you keep your money. The banker is here sitting next to a counter.

You can see Banker here.

>west
1st floor of Hospital
What is the waiting room should be called the emergency room. It is usually bustling with people but today it is eerily quiet.

>east
Bank
The safest place in the town. Where else would you keep your money. The banker is here sitting next to a counter.

You can see Banker here.

>north
Main road
a mostly abandoned road with one parked car on the left side of the road.

A parked car.

>look at car
You see nothing special about car.

>north
shop
I think that a coffin could be made here fairly easy. There is a circular saw in the room.

A strong little man who is a fine woodworker.

You can also see circular saw (empty) here.

>talk to woodworker
You can't see any such thing.

>talk to worker
 Do you want a coffin because i can build one.

>yes
That was a rhetorical question.

>okay
That's not a verb I recognise.

>west
Lumber yard
What else could it be. There is a hand saw in the room. There is also some wood.

You can see rough plank here.

>look at plank
You see nothing special about rough plank.

>take plank
Taken.

>east
shop
I think that a coffin could be made here fairly easy. There is a circular saw in the room.

A strong little man who is a fine woodworker.

You can also see circular saw (empty) here.

>take saw
Taken.

>west
Lumber yard
What else could it be. There is a hand saw in the room. There is also some wood.

>east
shop
I think that a coffin could be made here fairly easy. There is a circular saw in the room.

A strong little man who is a fine woodworker.

>south
Main road
a mostly abandoned road with one parked car on the left side of the road.

A parked car.

>north
shop
I think that a coffin could be made here fairly easy. There is a circular saw in the room.

A strong little man who is a fine woodworker.

>talk to worker
I will make a coffin for you right away.

>okay
That's not a verb I recognise.

>south
Main road
a mostly abandoned road with one parked car on the left side of the road.

A parked car.

>south
Bank
The safest place in the town. Where else would you keep your money. The banker is here sitting next to a counter.

You can see Banker here.

>west
1st floor of Hospital
What is the waiting room should be called the emergency room. It is usually bustling with people but today it is eerily quiet.

* * *

>see corpse
That's not a verb I recognise.

>look at corpse
You see nothing special about corpse.

>take corpse
Taken.

>take bed
That's fixed in place.

>dammit
That's not a verb I recognise.

>okay
That's not a verb I recognise.

>down
1st floor of Hospital
What is the waiting room should be called the emergency room. It is usually bustling with people but today it is eerily quiet.

* * *

>east
Bank
The safest place in the town. Where else would you keep your money. The banker is here sitting next to a counter.

You can see Banker here.

>inventory
You are carrying:
  corpse
  Coffin
  circular saw
  clothes
  wad of cash
  ID card

>south
Not every direction holds something of value. Go in another direction.

>east
clothing emporium
Some very nice clothes are made here. A tailor and a pedestal is here.

>west
Bank
The safest place in the town. Where else would you keep your money. The banker is here sitting next to a counter.

You can see Banker here.

>wes
That's not a verb I recognise.

>west
1st floor of Hospital
What is the waiting room should be called the emergency room. It is usually bustling with people but today it is eerily quiet.

>south
Funeral House
This is where all the magic happens (so to speak). In reality it is a large room with oak walls and an old dusty in the front. If you bring the full casket together put it here to let the funeral continue.

* * *

>south
Graveyard
It's a graveyard, what do you expect? A haunted house... There seems to be a fresh grave here mabye we should check it out.

>north
Funeral House
This is where all the magic happens (so to speak). In reality it is a large room with oak walls and an old dusty in the front. If you bring the full casket together put it here to let the funeral continue.

>combine
What do you want to combine?

>inventory
You are carrying:
  corpse
  Coffin
  circular saw
  clothes
  wad of cash
  ID card

>combine corpse with coffin
You fuse together corpse and Coffin.

You now have a coffin+corpse.

>combine coffin+corpse with clothes
You fuse together coffin+corpse and clothes.

You now have a full casket.

>okay
That's not a verb I recognise.

>i wil
I only understood you as far as wanting to take inventory.

>win*
That's not a verb I recognise.

>katsu
That's not a verb I recognise.

>kachimasu
That's not a verb I recognise.

* * *

>bring casket
That's not a verb I recognise.

>take casket
You can't see any such thing.

>touch old dusty
You can't see any such thing.

>move north
You must name something more substantial.

>north
1st floor of Hospital
What is the waiting room should be called the emergency room. It is usually bustling with people but today it is eerily quiet.

* * *

>up
2nd Floor of Hospital
This is where the worst patients are kept. there seems to be a couple not breathing. there is a body in here.

You can see corpse and Bed here.

>up
Not every direction holds something of value. Go in another direction.

>take corpse
Taken.

>i
You are carrying:
  corpse

>down
1st floor of Hospital
What is the waiting room should be called the emergency room. It is usually bustling with people but today it is eerily quiet.

>x
(corpse)
You see nothing special about corpse.

>east
Bank
The safest place in the town. Where else would you keep your money. The banker is here sitting next to a counter.

You can see Banker here.

>talk banker
I didn't understand that sentence.

>talk to banker
Your bank account seems to be empty.

>take banker
I don't suppose Banker would care for that.

* * *

>take all
There are none at all available!

* * *

>s
Graveyard
It's a graveyard, what do you expect? A haunted house... There seems to be a fresh grave here mabye we should check it out.

>x grave
In headstone is ID card.

>take id card
Taken.

>take ID
You already have that.

>n
Funeral House
This is where all the magic happens (so to speak). In reality it is a large room with oak walls and an old dusty in the front. If you bring the full casket together put it here to let the funeral continue.

>n
1st floor of Hospital
What is the waiting room should be called the emergency room. It is usually bustling with people but today it is eerily quiet.

>w
Not every direction holds something of value. Go in another direction.

>e
Bank
The safest place in the town. Where else would you keep your money. The banker is here sitting next to a counter.

You can see Banker here.

>talk to banker
Ah yes Mr. Nakagawa here is your money.

>i
You are carrying:
  wad of cash
  ID card

>w
1st floor of Hospital
What is the waiting room should be called the emergency room. It is usually bustling with people but today it is eerily quiet.

>take corpse
You can't see any such thing.

>up
2nd Floor of Hospital
This is where the worst patients are kept. there seems to be a couple not breathing. there is a body in here.

You can see corpse and Bed here.

>take bed
That's fixed in place.

>take corpse
Taken.

* * *

>x grave
In headstone is ID card.

>take id
Taken.

>n
Funeral House
This is where all the magic happens (so to speak). In reality it is a large room with oak walls and an old dusty in the front. If you bring the full casket together put it here to let the funeral continue.

* * *

>x grave
In headstone is ID card.

>look at grave
In headstone is ID card.

>x id card
Jonathan Nakagawa, 6/7/99... It seems to be the dead person.

>x headstone
In headstone is ID card.

* * *

I beg your pardon?

I beg your pardon?

* * *

>x walls
You can't see any such thing.

>x self
As good-looking as ever.

>x casket
You can't see any such thing.

>l
Funeral House
This is where all the magic happens (so to speak). In reality it is a large room with oak walls and an old dusty in the front. If you bring the full casket together put it here to let the funeral continue.

>n
1st floor of Hospital
What is the waiting room should be called the emergency room. It is usually bustling with people but today it is eerily quiet.

>x
What do you want to examine?

>n
You see nothing unexpected in that direction.

>se
Not every direction holds something of value. Go in another direction.

>n
Not every direction holds something of value. Go in another direction.

>s
Funeral House
This is where all the magic happens (so to speak). In reality it is a large room with oak walls and an old dusty in the front. If you bring the full casket together put it here to let the funeral continue.

>s
Graveyard
It's a graveyard, what do you expect? A haunted house... There seems to be a fresh grave here mabye we should check it out.

* * *

>take id card
Taken.

>x id card
Jonathan Nakagawa, 6/7/99... It seems to be the dead person.

>s
Not every direction holds something of value. Go in another direction.

>e
Not every direction holds something of value. Go in another direction.

>w
Not every direction holds something of value. Go in another direction.

>n
Funeral House
This is where all the magic happens (so to speak). In reality it is a large room with oak walls and an old dusty in the front. If you bring the full casket together put it here to let the funeral continue.

>e
Not every direction holds something of value. Go in another direction.

* * *

>w
Not every direction holds something of value. Go in another direction.

>n
1st floor of Hospital
What is the waiting room should be called the emergency room. It is usually bustling with people but today it is eerily quiet.

>e
Bank
The safest place in the town. Where else would you keep your money. The banker is here sitting next to a counter.

You can see Banker here.

>w
1st floor of Hospital
What is the waiting room should be called the emergency room. It is usually bustling with people but today it is eerily quiet.

>s
Funeral House
This is where all the magic happens (so to speak). In reality it is a large room with oak walls and an old dusty in the front. If you bring the full casket together put it here to let the funeral continue.

>e
Not every direction holds something of value. Go in another direction.

>n
1st floor of Hospital
What is the waiting room should be called the emergency room. It is usually bustling with people but today it is eerily quiet.

* * *

>e
Bank
The safest place in the town. Where else would you keep your money. The banker is here sitting next to a counter.

You can see Banker here.

>talk to banket
You can't see any such thing.

>talk to banker
Ah yes Mr. Nakagawa here is your money.

>give banker id card
You give ID card to Banker.

>i
You are carrying:
  wad of cash

>e
clothing emporium
Some very nice clothes are made here. A tailor and a pedestal is here.

>talk to tailor
I will make some clothes for you right away.

>i
You are carrying:
  clothes
  wad of cash

>x pedestal
You see nothing special about pedestal.

>take pedestal
That's fixed in place.

>step on pedestal
That's not a verb I recognise.

>get on pedestal
That's not something you can enter.

>enter pedestal
That's not something you can enter.

>e
Not every direction holds something of value. Go in another direction.

>w
Bank
The safest place in the town. Where else would you keep your money. The banker is here sitting next to a counter.

You can see Banker here.

>e
clothing emporium
Some very nice clothes are made here. A tailor and a pedestal is here.

>n
Not every direction holds something of value. Go in another direction.

>s
Not every direction holds something of value. Go in another direction.

>n
Not every direction holds something of value. Go in another direction.

>e
Not every direction holds something of value. Go in another direction.

* * *

>w
Bank
The safest place in the town. Where else would you keep your money. The banker is here sitting next to a counter.

You can see Banker here.

>s
Not every direction holds something of value. Go in another direction.

>e
clothing emporium
Some very nice clothes are made here. A tailor and a pedestal is here.

>w
Bank
The safest place in the town. Where else would you keep your money. The banker is here sitting next to a counter.

You can see Banker here.

>w
1st floor of Hospital
What is the waiting room should be called the emergency room. It is usually bustling with people but today it is eerily quiet.

>e
Bank
The safest place in the town. Where else would you keep your money. The banker is here sitting next to a counter.

You can see Banker here.

>n
Main road
a mostly abandoned road with one parked car on the left side of the road.

A parked car.

>x parked car
You can't see any such thing.

>x car
You see nothing special about car.

>enter car
That's not something you can enter.

>get in car
That's not something you can enter.

>x car
You see nothing special about car.

>n
shop
I think that a coffin could be made here fairly easy. There is a circular saw in the room.

A strong little man who is a fine woodworker.

You can also see circular saw (empty) here.

>take saw
Taken.

>x man
You can't see any such thing.

>x strong little man
You can't see any such thing.

>talk to worker
 Do you want a coffin because i can build one, but I need wood and some sort of payment.

>give worker money
You can't see any such thing.

>give cash to worker
You give wad of cash to Worker.

>n
Not every direction holds something of value. Go in another direction.

* * *

>e
Not every direction holds something of value. Go in another direction.

>w
Lumber yard
What else could it be. There is a hand saw in the room. There is also some wood.

You can see rough plank here.

>take plank
Taken.

>e
shop
I think that a coffin could be made here fairly easy. There is a circular saw in the room.

A strong little man who is a fine woodworker.

>give plank to worker
You give rough plank to Worker.

* * *

>take plank
That seems to belong to Worker.

>take cash
That seems to belong to Worker.

>undo
shop
[Previous turn undone.]

>unod
That's not a verb I recognise.

>undo
shop
[Previous turn undone.]

>undo
shop
[Previous turn undone.]

>i
You are carrying:
  circular saw
  clothes

>i
You are carrying:
  circular saw
  clothes

>undo
shop
[Previous turn undone.]

>undo
Lumber yard
[Previous turn undone.]

>undo
Lumber yard
[Previous turn undone.]

I beg your pardon?

>undo
The use of "undo" is forbidden in this game.

>undo
The use of "undo" is forbidden in this game.

>i
You are carrying:
  circular saw
  clothes

>undo
Lumber yard
[Previous turn undone.]

>undo
The use of "undo" is forbidden in this game.

* * *

>undo
Lumber yard
[Previous turn undone.]

>i
You are carrying:
  circular saw
  clothes

* * *

>e
Bank
You can see Banker here.

>n
Main road

>n
shop
You can see circular saw (empty) here.

>e
You can't go that way.

>w
Lumber yard
You can see rough plank here.

>get all
(rough plank)
Taken.

>s
You can't go that way.

>e
shop
You can see circular saw (empty) here.

>put plank in saw
You put rough plank into circular saw.

* * *

>n
1st floor of Hospital
What is the waiting room should be called the emergency room. It is usually bustling with people but today it is eerily quiet.

>n
Not every direction holds something of value. Go in another direction.

>e
Bank
You can see Banker here.

>talk to banker
[1] hello

>1
That's not a verb I recognise.

* * *

>n
Not every direction holds something of value. Go in another direction.

>w
Not every direction holds something of value. Go in another direction.

* * *

>e
Bank
The safest place in the town. Where else would you keep your money. The banker is here sitting next to a counter.

You can see Banker here.

>talk to banker
Your bank account seems to be empty.

>s
Not every direction holds something of value. Go in another direction.

>s
Not every direction holds something of value. Go in another direction.

>n
Main road
a mostly abandoned road with one parked car on the left side of the road.

A parked car.

>s
Bank
The safest place in the town. Where else would you keep your money. The banker is here sitting next to a counter.

You can see Banker here.

>w
1st floor of Hospital
What is the waiting room should be called the emergency room. It is usually bustling with people but today it is eerily quiet.

* * *

>s
Graveyard
It's a graveyard, what do you expect? A haunted house... There seems to be a fresh grave here mabye we should check it out.

>take id card
Taken.

>n
Funeral House
This is where all the magic happens (so to speak). In reality it is a large room with oak walls and an old dusty in the front. If you bring the full casket together put it here to let the funeral continue.

* * *

>n
1st floor of Hospital
What is the waiting room should be called the emergency room. It is usually bustling with people but today it is eerily quiet.

>s
Funeral House
This is where all the magic happens (so to speak). In reality it is a large room with oak walls and an old dusty in the front. If you bring the full casket together put it here to let the funeral continue.

* * *

>e
Bank
The safest place in the town. Where else would you keep your money. The banker is here sitting next to a counter.

You can see Banker here.

>give id card to banket
You can't see any such thing.

>give id to banker
You give ID card to Banker.

>talk to banket
You can't see any such thing.

>talk to banker
Your bank account seems to be empty.

>i
You are carrying nothing.

>talk to banket
You can't see any such thing.

* * *

>s
Graveyard
It's a graveyard, what do you expect? A haunted house... There seems to be a fresh grave here mabye we should check it out.

>n
Funeral House
This is where all the magic happens (so to speak). In reality it is a large room with oak walls and an old dusty in the front. If you bring the full casket together put it here to let the funeral continue.

* * *

>n
Main road
a mostly abandoned road with one parked car on the left side of the road.

A parked car.

>n
shop
I think that a coffin could be made here fairly easy. There is a circular saw in the room.

A strong little man who is a fine woodworker.

You can also see circular saw (empty) here.

* * *

>n
1st floor of Hospital
What is the waiting room should be called the emergency room. It is usually bustling with people but today it is eerily quiet.

>get corpse
Taken.

>w
You can't go that way.

>n
You can't go that way.

>e
Bank
You can see Banker here.

>e
Tailor
You can see clothes here.

>w
Bank
You can see Banker here.

>e
Tailor
You can see clothes here.

>n
You can't go that way.

>w
Bank
You can see Banker here.

* * *

>e
Tailor
You can see clothes here.

>c
That's not a verb I recognise.

>w
Bank
You can see Banker here.

* * *

>e
Tailor
You can see clothes here.

>take coffin
You can't see any such thing.

>s
You can't go that way.

>w
Bank
You can see Banker here.

* * *

>e
Tailor
You can see clothes here.

>sw
You can't go that way.

>se
You can't go that way.

>s
You can't go that way.

>e
You can't go that way.

>i
You are carrying:
  corpse

>w
Bank
You can see Banker here.

>n
Main road

>n
shop
You can see circular saw (empty) and Coffin here.

>take coffin
Taken.

>s
Main road

>s
Bank
You can see Banker here.

>e
Tailor
You can see clothes here.

>take clothes
Taken.

>i
You are carrying:
  clothes
  Coffin
  corpse

>combine
What do you want to combine?

>corpse and coffin
You can't use multiple objects with that verb.

>combine coffin with corpse
You fuse together Coffin and corpse.

You now have a coffin+corpse.

>combine coffin+corpse with clothes
You fuse together coffin+corpse and clothes.

You now have a full casket.

* * *

>n
1st floor of Hospital
What is the waiting room should be called the emergency room. It is usually bustling with people but today it is eerily quiet.

>e
Bank
The safest place in the town. Where else would you keep your money.

You can see Banker here.

>n
Main road

>s
Bank
You can see Banker here.

* * *

>e
Bank
The safest place in the town. Where else would you keep your money.

You can see Banker here.

>talk to banker
Ah, yes here is your money

>n
Main road
a mostly abandoned road with one parked car on the left side of the road.

A parked car.

>n
shop
I think that a coffin could be made here farily easy. There is a circular saw in the room.

A strong little man hwo is a fine woodworker.

You can also see circular saw (empty) and Coffin here.

>talk to worker
 Do you want a coffin because i can build one.

>e
Not every direction holds something of value. Go in another direction.

I beg your pardon?

>w
Lumber yard
What else could it be. There is a hand saw in the room.

You can see rough plank here.

>get all
That would make things to easy, try to have some fun :)

>get plank
Taken.

>e
shop
I think that a coffin could be made here farily easy. There is a circular saw in the room.

A strong little man hwo is a fine woodworker.

You can also see circular saw (empty) and Coffin here.

>talk to worker
I will make a coffin for you right away.

>i
You are carrying:
  Coffin
  wad of cash

* * *

>sit on table
That's not something you can sit down on.

* * *

>i
You are carrying nothing.

>s
Graveyard
It's a graveyard, what do you expect? A haunted house... There seems to be a fresh grave here mabye we should check it out.

* * *

>i
You are carrying:
  wad of cash
  ID card

>e
clothing emporium
Some very nice clothes are made here. A tailor and a pedestal is here.

* * *

>talk to tailor
I will make some clothes for you right away.

>i
You are carrying:
  clothes
  wad of cash
  ID card

>e
Not every direction holds something of value. Go in another direction.

* * *

>s
Not every direction holds something of value. Go in another direction.

I beg your pardon?

>e
clothing emporium
Some very nice clothes are made here. A tailor and a pedestal is here.

* * *

>s
Not every direction holds something of value. Go in another direction.

>w
Bank
The safest place in the town. Where else would you keep your money. The banker is here sitting next to a counter.

You can see Banker here.

>n
Main road
a mostly abandoned road with one parked car on the left side of the road.

A parked car.

* * *

>n
shop
I think that a coffin could be made here fairly easy. There is a circular saw in the room.

A strong little man who is a fine woodworker.

You can also see circular saw (empty) here.

>n
Not every direction holds something of value. Go in another direction.

* * *

>take plank
Taken.

>s
Not every direction holds something of value. Go in another direction.

>take saw
You can't see any such thing.

I beg your pardon?

>s
Not every direction holds something of value. Go in another direction.

>e
shop
I think that a coffin could be made here fairly easy. There is a circular saw in the room.

A strong little man who is a fine woodworker.

You can also see circular saw (empty) here.

>take saw
Taken.

>i
You are carrying:
  circular saw
  rough plank
  clothes
  wad of cash
  ID card

>talk to man
You can't see any such thing.

>talk to worker
 Do you want a coffin because i can build one, but I need wood and some sort of payment.

>i
You are carrying:
  circular saw
  rough plank
  clothes
  wad of cash
  ID card

* * *

>sit at table
I didn't understand that sentence.

>sit on table
That's not something you can sit down on.

>sit
(on the Table)
That's not something you can sit down on.